25 20
0000000000000000000000000
0111111111111111111111110
0111111111111111111111110
0118111111181111121144410
0111911111111119114445440
0111111111111111144566640
0222211111222111446665640
0222211111111111144566440
0111111111111111114464410
0111111121111111111444110
0119111111111181111111110
0222111111111111111111110
0222144411911111911118110
0114445441111221111111110
0144566641111221111111110
0146665641111111111111910
0144566441111119111111110
0114464411111111111911110
0111444111911111111111170
0000000000000000000000000

0 - border
1 - grass0
2 - grass
3 - bigtree
4 - ground
5 - lake
6 - lake1 
7 - port 
8 - tree01
9 - tree0