25 20
0000000000000000000000000
0111111166611111119111110
0111181116666111111111110
0111111111166611111811110
0111133111111111111111110
0111111111s11111111331110
0111111111111111114441110
01111111s1111111445654410
011111111111p114565656410
0111111p11111146666666410
0191111111111466666666410
0111111111114665666444410
0111191133146656664111110
0111111111466666641111110
0111111111146666664111110
01181111111s4666666411110
0#11111111111466664111560
0713311911111144441111660
0111111111111111111111110
0000000000000000000000000

0 - border
1 - grass0
2 - grass
3 - grass1
4 - ground
5 - lake
6 - lake1
7 - port
8 - tree01
9 - tree0
b - bigtree


# - player
s - snake
p - python
p - python