25 20
0000000000000000000000000
0111111111111111111111110
0111111111111111111111110
0118331111183333331144410
0113311193133339334445440
011333#133133113344566640
0222211111222111446665640
0222211111111111144566440
0111111111111111114464410
0111911121111111111444110
0111111111111181111111110
0222111111111111111111110
0222144411911111911118110
0114445441111221111111110
0144566641s11221111s11110
0146665641111111111111910
0144566441111119111111110
0114464411911111111911170
0111444111111111111111110
0000000000000000000000000

0 - border
1 - grass0
2 - grass
3 - grass1
4 - ground
5 - lake
6 - lake1 
7 - port 
8 - tree01
9 - tree0
b - bigtree


# - player
s - snake
d - python
p - python